Австралия = кенгуру + страна 
Автомобиль = ДВС + телега 
Айфон = телефон + фрукт 
Аквариум = стекло + рыба 
Алкаш = человек + водка 
Алкаш = человек + пиво 
Алкаш = человек + спирт 
Алмаз = уголь + давление 
Альберт_Эйнштейн = ученый + энергия 
Алюминий = самолет + металл
Бабочка = воздух + червь 
Бактерии = жизнь + болото
Бамбук = трава + земля 
Банан = обезьяна + фрукты 
Банк = дом + деньги 
Банка = алюминий + стакан 
Бар = кирпичный_дом + пиво
Барабан = ткань + керамика
Бассейн = дом + вода 
Бекон = огонь + свинья 
Белоруссия = трактор + страна 
Бензин = давление + нефть 
Бетмен = летучая_мышь + человек
Бетон = вода + цемент 
Библиотека = книга + книга
Билет = цирк + бумага 
Бинт = кровь + ткань 
Битлз = жук + жук 
Битум = давление + кероген 
Бобёр = плотина + зверь 
Богомол = аквариум + гусеница 
Болото = вода + земля 
Больница = кирпичный_дом + больной
Больной = грипп + человек 
Борщ = свекла + огонь 
Ботинки = кожа + мостовая 
Бриллиант = алмаз + инструмент 
Бумага = давление + древесина
Бункер = дом + земля 
Буратино = древесина + жизнь 
Буря = энергия + воздух
Бэтмен = человек + летучая мышь
Вампир = кровь + человек 
Великобритания = Робин_Гуд + страна 
Велосипед = колесо + колесо 
Венера = женщина + планета 
Венеция = город + вода 
Верблюд = пустыня + зверь 
Ветер = воздух + воздух 
Взрыв = огонь + бензин
Викодин = больной + доктор 
Вино = бактерии + виноград 
Виноград = земля + древесина 
Влажный_воздух = вода + воздух 
Вода = лёд + огонь 
Водка = спирт + вода 
Водород = вода + электричество 
Водоросли = жизнь + вода 
Воин = оружие + охотник 
Волк = луна + зверь 
Время = жизнь + песочные_часы 
Вулкан = лава + гейзер
Вурдалак = труп + зомби 
Газировка = вода + углекислый_газ 
Газонокосилка = трава + инструмент 
Гамбургер = жареное мясо + хлеб 
Гейзер = пар + земля 
Германия = Фольксваген_Жук + страна 
Герой = дракон + воин 
Гладиатор = воин + колесница
Гладиатор = Колизей + человек 
Глина = песок + болото 
Голем = глина + жизнь 
Город = небоскреб + небоскреб 
Горячий_шоколад = шоколад + огонь 
Гремучий_газ = кислород + водород 
Гренки = огонь + хлеб 
Гриб = земля + водоросли 
Грипп = воздух + бактерии 
Гриф = птица + кровь 
Гриф = птица + труп 
Гроб = труп + древесина 
Гроза = буря + электричество 
Гром = буря + звук 
Гром-птица = буря + птица 
Громоотвод = гроза + металл 
Грязь = вода + земля
Давление = земля + земля 
Давление = пар + паровой_котёл 
ДВС = паровой_двигатель + бензин 
Дороз = старик + новогодняя_елка 
Деньги = монета + бумага 
Дерево = земля + растение 
Деревянный_корабль = лодка + древесина 
Джедай = герой + световой_меч 
Джинн = лампа + призрак 
Диета = человек + кефир 
Дилемма = яйцо + курица 
Динамит = порох + сахар 
Динозавр = земля + яйцо 
Дождь = облако + вода 
Доктор = больной + ученый 
Доктор зойдберг = лобстер + доктор 
Доктор Хаус = доктор + викодин 
Дом = кирпич + человек
Домашний_скот = зверь + человек 
Дракон = огонь + динозавр 
Древесина = инструмент + дерево 
Духи = цветок + спирт 
Дым = огонь + трава 
Дым = огонь + табак
Египет = мумия + страна
Жареное_мясо = огонь + мясо 
Железо = земля + метеор 
Жемчуг = песок + ракушки 
Женщина = молоко + человек 
Жизнь = энергия + болото 
Жир = человек + свинья 
Жук = земля + червь
Заключённый = убийца + время 
Звезда = солнце + ученый 
Зверь = земля + ящерица 
Звук = металл + ветер 
Звёздные войны = ситх + джедай 
Здание = дом + сталь 
Зеркало = стекло + огонь 
Змея = болото + червь
Золото = алюминий + философский_камень 
Зомби = жизнь + окаменелость 
Зомби = жизнь + труп
Зоопарк = музей + зверь
Идея = человек + лампочка 
Известняк = ракушки + камень 
Известь = огонь + известняк 
Икра = рыба + рыба 
Индия = камасутра + страна 
Инструмент = человек + металл 
Исландия = лед + страна 
Исландия = вулкан + страна 
Италия = пицца + страна 
Йод = водоросли + огонь 
Йода = джедай + лягушка 
Йоши = 1up + яйцо 
Какао = Мексика + семена 
Кактус = пустыня + дерево 
Камасутра = книга + секс 
Камень = лава + вода 
Карамель = сахар + огонь 
Кармин = кошениль + огонь 
Катер = лодка + ДВС 
Кенгуру = лягушка + зверь 
Керамика = глина + человек 
Кероген = окаменелость + давление 
Кетцалькоатль = змея + перо
Кефир = бактерии + молоко 
Килт = Шотландия + одежда 
Кирпич = глина + огонь 
Кирпичный_дом = кирпич + бетон 
Кислород = вода + электричество 
Кит = вода + зверь 
Китай = страна + дракон 
Кладбище = могила + могила 
Клещ = жизнь + пыль 
Книга = бумага + бумага 
Кока_кола = газировка + кармин 
Коктейль_Молотова = огонь + спирт 
Кол = древесина + нож 
Колесница = воин + телега 
Колесо = инструмент + древесина 
Колизей = динамит + здание 
Компас = магнит + стекло 
Континент = страна + страна 
Копилка = монета + керамика 
Кот = мышь + охотник 
Котопес = кот + собака 
Кошениль = кактус + жук 
Кремний = песок + энергия 
Кровь = птица + охотник 
Круги_на_полях = НЛО + пашня 
Курица = яйцо + жизнь 
Курица_гриль = курица + огонь 
Курятник = курица + хижина 
Куст = папоротник + земля 
Лава = земля + огонь 
Лава = давление + вулкан 
Лавовая_лампа = лампа + лава 
Лавовый_голем = жизнь + лава 
Лампа = огонь + стекло 
Лампочка = электричество + стекло
Лес = дерево + дерево 
Летучая мышь = птица + вампир 
Лёд = стекло + вода 
Лишайник = гриб + бактерии 
Лобстер = скорпион + вода 
Лодка = вода + древесина 
Лошадь = трава + млекопитающее 
Лук = Робин Гуд + оружие 
Луна = небо + сыр 
Луна = Солнце + зеркало 
Лэнс_Армстронг = рак + велосипед 
Лягушка = ящерица + болото 
Магнит = земля + железо
Марио = 1UP + человек 
Масло = инструмент + молоко 
Машина = телега + ДВС 
Маяк = небоскреб + свет 
Медведь = зверь + лес 
Медь = серебро + золото 
Мексика = текила + страна 
Ментос = кока-кола + гейзер 
Металл = огонь + камень 
Металлический_голем = металл + жизнь 
Метеор = воздух + огонь 
Мёд = пчела + цветок 
Микросхема = транзистор + транзистор 
Могила = земля + труп 
Молния = воздух + огонь
Молоко = домашний скот + трава 
Монеты = серебро + давление 
Море = вода + вода
Моряк = лодка + человек 
Мотоцикл = велосипед + ДВС 
Мох = болото + водоросли 
Музей = кирпичный_дом + окаменелость 
Музыка = звук + идея 
Мука = пшеница + инструмент 
Мумия = ткань + труп 
Мучной жук = мука + жук 
Мыло = пепел + жир 
Мышь = сыр + зверь 
Мясо = птица + охотник
Навоз = трава + домашний_скот 
Небо = воздух + облако
Небоскрёб = кирпичный_дом + стекло 
Нефть = битум + давление 
Нить = пряжа + прялка 
НЛО = пришелец + самолет 
Новогодняя_ёлка = дерево + лампочка 
Нож = мясо + инструмент 
Ножницы = нож + нож 
Обезьяна = человек + шерсть 
Облако = воздух + пар
Оборотень = зверь + вампир 
Огненный элементал = огонь + жизнь 
Огнестрельное_оружие = оружие + порох 
Одежда = ткань + человек 
Ожирение = человек + Mcdonald’s 
Озон = электричество + воздух
Окаменелость = земля + динозавр
Оружие = металл + инструмент 
Остров = вулкан + море 
Отравленное оружие = оружие + яд 
Охотник = человек + оружие 
Охотники_за_приведениями = охотник + призрак 
Панда = дерево + зверь 
Панцирь = охотник + черепаха 
Папоротник = мох + болото 
Пар = воздух + вода 
Паровоз = телега + паровой_двигатель 
Паровой_двигатель = паровой_котел + уголь 
Паровой_котёл = металл + пар 
Пароход = паровой_двигатель + деревянный_корабль 
Парусная_лодка = лодка + ткань 
Парусник = ткань + деревянный_корабль 
Пашня = земля + инструмент
Пенициллин = плесень + ученый 
Пепел = огонь + книга 
Пепельница = пепел + стекло 
Перо = птица + охотник 
Песок = камень + вода
Песочные_часы = стекло + песок 
Песчаная_буря = буря + песок 
Пиво = спирт + хлеб 
Пинаколада = молоко + ром 
Пингвин = птица + лед 
Пират = моряк + меч
Пирог = ягода + тесто 
Пицца = сыр + тесто 
Пиявка = кровь + червь 
Планета = континент + континент 
Планктон = бактерии + вода 
Плезиозавр = динозавр + вода 
Плесень = гриб + грязь 
Плотина = кирпич + вода 
Пляж = вода + песок 
Подсолнух = солнце + цветок 
Подушка = перо + ткань 
Пожарный = огонь + воин
Порох = пыль + огонь 
Призрак = пепел + жизнь 
Пришелец = звезда + зверь 
Провод = нить + медь 
Простокваша = молоко + кефир 
Пряжа = прялка + шерсть 
Прялка = колесо + шерсть 
Птеродактиль = воздух + динозавр 
Птица = воздух + яйцо 
Птичий_грипп = грипп + птица 
Пустыня = песок + песок 
Пчела = цветок + жук 
Пшеница = пашня + трава 
Пыль = воздух + земля 
Радуга = вода + свет 
Рак = человек + сигареты 
Ракушки = планктон + камень 
Ребенок = жизнь + секс 
Ржавчина = металл + вода 
Робин Гуд = лес + герой 
Робот = металлический_голем + электричество 
Ром = водка + пират 
Роща = дерево + дерево 
Рубин = алюминий + кислород 
Румыния = страна + трансильвания 
Русалка = женщина + рыба 
Рыба = бактерии + планктон 
Рыбак = охотник + рыба 
Рыцарь = охотник + оружие 
Садовод = человек + пашня 
Саламандра = огонь + ящерица 
Сало = человек + свинья 
Самолёт = птица + металл 
Саудовская_Аравия = нефть + страна 
Сауна = пар + человек 
Сахар = известь + тростник 
Свекла= ученый + тростник 
Свет = электричество + лампочка 
Светлячок = свет + жук 
Световой_меч = оружие + свет
Свиной_грипп = свинья + грипп 
Свинья = грязь + домашний скот 
Свитер = пряжа + пряжа 
Секс = женщина + человек 
Секс_в_большом_городе = город + секс 
Селитра = известняк + навоз 
Семена = жизнь + песок 
Сера = бактерии + болото 
Серебро = луна + металл 
Сигареты = бумага + табак 
Ситх = джедай + убийца 
Скарабей = жук + навоз 
Скорая_помощь = больница + машина 
Скорпион = жук + песок 
Слон = Индия + зверь = земля + кит 
Снайпер = убийца + огнестрельное_оружие 
Снег = холод + дождь 
Собака = волк + человек 
Сок = фрукт + давление 
Солдат = огнестрельное_оружие + человек
Солнце = небо + колесница 
Соль = огонь + море 
Спартак = гладиатор + герой 
Спирт = огонь + вода 
Сталь = железо + уголь 
Старик = человек + время 
Статуя = камень + инструмент 
Статуя_свободы = США + Франция 
Стекло = огонь + песок 
Страна = город + город 
Сумерки сага = вампир + оборотень 
Суши = рыба + водоросли 
США = Mcdonald’s + страна 
Сыворотка = простокваша + огонь 
Сыр = творог + огонь 
Сэндвич = мясо + хлеб 
Табак = огонь + трава 
Тайфун = буря + вода 
Танк = огнестрельное_оружие + телега 
Творог = простокваша + огонь 
Текила = спирт + червь
Телега = колесо + древесина 
Телефон = провод + звук 
Тесто = мука + вода 
Ткань = инструмент + шерсть 
Торф = болото + дерево 
Тоторо = лес + призрак 
Трава = земля + мох 
Трактор = газонокосилка + пашня 
Транзистор = кремний + ученый 
Трансильвания = вампир + страна 
Трансформеры = машина + жизнь 
Тростник = трава + болото 
Труп = человек + огонь
Убийца = человек + отравленное_оружие 
Углекислый_газ = кислород + человек 
Уголь = огонь + дерево 
Удобрение = домашний_скот + тpава 
Украина = сало + страна 
Уксус = спирт + кислород 
Улитка = ракушки + червь 
Упряжка = зверь + телега 
Учёный = библиотека + человек 
Феникс = птица + огонь 
Философ = учёный + книга 
Философия = дилемма + ученый 
Философский_камень = философия + камень 
Финляндия = сауна + страна 
Фольксваген Жук = машина + жук 
Фондю = сыр + огонь 
Франкенштейн = труп + электричество
Франция = страна + духи 
Фрукт = цветок + дерево 
Фугу = рыба + яд 
Фульгурит = молния + песок
Хижина = человек + камень 
Хлеб = тесто + огонь 
Ходячее_дерево = жизнь + дерево 
Цветок = семена + вода
Цемент = глина + известняк 
Часы = время + инструмент 
Чашка_Петри = стекло + бактерии 
Человек = жизнь + зверь 
Человек = жизнь + голем 
Червь = земля + планктон
Черепаха = яйцо + песок
Чизбургер = гамбургер + сыр 
Шампанское = вино + углекислый_газ 
Швейцария = страна + часы 
Швейцарский_нож = нож + Швейцария
Шелк = пряжа + червь 
Шерсть = человек + домашний скот 
Шоколад = какао + сахар 
Шотландия = шотландский_виски + страна 
Шотландский_виски = спирт + дым
Щит = панцирь + инструмен
Эктоплазма = призрак + энергия 
Электрический_скат = рыба + электричество 
Электрический_угорь = электричество + змея 
Электричество = энергия + металл 
Электричество = шерсть + стекло 
Электронная_книга = микросхема + книга 
Энергия = огонь + воздух 
Энты = дерево + жизнь 
Яблоко = дерево + фрукты = дерево + цветок 
Яблочный пирог = тесто + яблоко 
Ягода = трава + фрукт 
Яд = инструмент + скорпион 
Яд = инструмент + змея 
Яичница = яйцо + огонь 
Яйца_Фаберже = яйцо + бриллиант 
Яйцо = жизнь + камень 
Якорь = цепь + судно 
Янтарь = время + смола 
Япония = суши + страна 
Ящерица = яйцо + болото 
